  0123456789
0 |--------|
1 |...|..-.|
2 |..-|.@..|
3 |......-.|
4 |--------|